########################################
#......#..............#......#.........#
#..<...#..............#................#
#...................#........####......#
#...#..............#........#...#......#
####...............#.......#....#......#
#.............<.......#......#.....#...#
#.................#..#####......#......#
#................#..#.....#.....##.....#
#..................#.......#......#....#
#.................#.........#......#...#
#............................#.....#...#
#.......................#.....#....#...#
#........................#.....#..#....#
#.........................#.....##.....#
#.........................####.#..#....#
#......................................#
#.....................########.#..#....#
#......................................#
########################################
